NO ./textures/xpm/blue.xpm
SO ./textures/xpm/brick.xpm
WE ./textures/xpm/grey.xpm
EA ./textures/xpm/wood.xpm

F 200,-1,300
C 25,110,4

111111111111111111111111111111
1E0000000001000000000000000001
100000000001000000000000000001
100000000001000000000000000001
100000000001000000000000000001
100000000000000000000000000001
100000000000000000000000000001
111111111111000000010000000001
100000000000000000010000000001
100000000000000000010000000001
100000000000000000010000000001
111111110100000000010000000001
100000000100000000010000000001
100000000100000000010111111111
100000000100000000000000000001
100000000100000000000000000001
111111111111111111111111111111
