NO ./textures/xpm/blue.xpm
SO ./textures/xpm/brick.xpm
WE ./textures/xpm/grey.xpm
EA ./textures/xpm/wood.xpm

F 255,10,0
C 55,60,10

111111111111111111111111111111
1E000F000001000000000000000001
1000F0F00001000000000000000001
111112111001000000000000000001
110000001001000000000000000001
110011111000000000000000000001
110010000000000000000000000001
111111111111000000010000000001
100000000000000000010000000001
100000000000000000010000000001
100000000000000000010000000001
111111110100000000010000000001
100000000100000000010000000001
100000000100000000010111111111
100000000100000000000000000001
100000000100000000000000000001
111111111111111111111111111111
